0 0

G G G G G G G
G G G G G G G
G G G B B B G
G G G B F B G
G G G B B B G
G G G G G G G
G G G G G G G

G G G G G G G
G G G G G G G
G G G B B B G
G G G B G B G
G G G B B B G
G G G G G G G
G G G G G G G 

G G G G G G G
G G G G G G G
G G G B B B G
G G G B G B G
G G G B B B G
G G G G G G G
G G G G G G G 

G G G G G G G
G G G G G G G
G G G B B B G
G G G B G B G
G G G B B B G
G G G G G G G
G G G G G G G 

G G G G G G G
G G G G G G G
G G G B B B G
G G G B G B G
G G G B B B G
G G G G G G G
G G G G G G G 

G G G G G G G
G G G G G G G
G G G B B B G
G G G B G B G
G G G B B B G
G G G G G G G
G G G G G G G 

E E E E E E E
E E E E E E E
E E E E E E E
E E E E E E E
E E E E E E E
E E E E E E E
E E E E E E E

E E E E E E E
E E E E E E E
E E E E E E E
E E E E S E E
E E E E E E E
E E E E E E E
E E E E E E E

E E E E E E E
E E E E E E E
E E E E E E E
E E E E D E E
E E E E E E E
E E E E E E E
E E E E E E E

E E E E E E E
E E E E E E E
E E E E E E E
E E E E E E E
E E E E E E E
E E E E E E E
E E E E E E E

E E E E E E E
E E E E E E E
E E E E E E E
E E E E H E E
E E E E E E E
E E E E E E E
E E E E E E E

E E E E E E E
E E E E E E E
E E E E E E E
E E E E S E E
E E E E E E E
E E E E E E E
E E E E E E E