0 0

G G G G G G G
G G G G G G G
G G G G G G G
G G G G F G G
G G G G G G G
G G G G G G G
G G G G G G G

G G G G G G G
G G G G G G G
G G G G G G G
G G G G G G G
G G G G G G G
G G G G G G G
G G G G G G G 

G G G G G G G
G G G G G G G
G G G G G G G
G G G G G G G
G G G G G G G
G G G G G G G
G G G G G G G

G G G G G G G
G G G G G G G
G G G G G G G
G G G G G G G
G G G G G G G
G G G G G G G
G G G G G G G

G G G G G G G
G G G G G G G
G G G G G G G
G G G G G G G
G G G G G G G
G G G G G G G
G G G G G G G

G G G G G G G
G G G G G G G
G G G G G G G
G G G G G G G
G G G G G G G
G G G G G G G
G G G G G G G

E E E E E E E
E E E E E E E
E E E E E E E
E E E E E E E
E E E E E E E
E E E E E E E
E E E E E E E

E E E E E E E
E E E E E E E
E E E E E E E
E E E E E E E
E E E E E E E
E E E E E E E
E E E E E E E

E E E E E E E
E E E E E E E
E E E E E E E
E E E E E E E
E E E E E E E
E E E E E E E
E E E E E E E

E E E E E E E
E E E E E E E
E E E E E E E
E E E E E E E
E E E E E E E
E E E E E E E
E E E E E E E

E E E E E E E
E E E E E E E
E E E E E E E
E E E E E E E
E E E E E E E
E E E E E E E
E E E E E E E

E E E E E E E
E E E E E E E
E E E E E E E
E E E E E E E
E E E E E E E
E E E E E E E
E E E E E E E