0 0

B B B B B B B
P B P P B P P
P B P P B P B
B B P P B P B
P B B B B B B
P B P P P P P
P B P P P P P

B B P P B B B
B B P P B P B
B B B B B B B
B B B P P P B
P P B B B P B
B P B P P P P
P P P P P P P

B B B P B B B
B B B P B P B
B B B P B P B
B B B P B P B 
B B B P P P P
B B B B B B B
P B B B B B B

B B B B B B B
B B P B B B B
P P P B B B P
P B B B B B B
P P P P B P P
B B B P B P B
P B B P P P P

P P P B B B B
P P P B B B B
P P B B B P B
P P B P B P B
B B B B B P B
B P P P P P P
P P P P P P P

B P B P B P B
P P P P P P P
B B B B B B B
B G B P B P P
B P B P B P B
B P B P B P B
P B B B B P B

E E E E E E E
E E E E E E E
E E E E E E E
E E H E E E E
E E E E E E E
E E E E E E E
E E E E E E E

E E E E E E S
E E E E E E E
E E E E E E E
E E E H E E E
E E E E E E E
E E E S E E E
E E E E E E E

E E E E E E E
E E E E E E E
E E E E E E E
E E E E E E E
E E E E E E E
E E E E E E E
E E E E E E E

E E E E E E E
E E E E E E E
E E E E E E E
E E E E E E E
E E E E E E E
E E E E E E E
E E E E E E E

E E E E E E E
E E E E E E E
E H E E E E E
E S E S E E E
E E E E E E E
E E E E E E E
E E E E E E E

E E E E E E E
E E E E E E E
E E E E E E E
E E E E E E E
E E E E E E E
E E E E E E E
E E E E E E E